14
2
2 2 31
7 7 32
11 11 11 11 11 11 11 11 11 11 11 11 11 11
11 0 0 0 0 0 0 0 0 0 0 0 0 11
11 0 11 0 11 0 11 11 0 11 0 11 0 11
11 0 0 0 0 0 0 0 0 0 0 0 0 11
11 0 11 0 1 11 1 0 11 0 0 11 0 11
11 0 0 0 11 0 0 0 0 11 0 0 0 11
11 0 11 0 1 0 1 1 0 0 1 11 0 11
11 0 11 0 0 0 1 41 0 0 0 11 0 11
11 0 0 0 11 0 0 0 0 11 1 0 0 11
11 0 11 0 0 11 0 0 11 0 0 11 0 11
11 0 1 42 1 0 1 0 1 0 0 0 0 11
11 0 11 0 11 0 11 11 0 11 0 11 0 11
11 0 0 0 0 0 0 0 0 0 0 0 0 11
11 11 11 11 11 11 11 11 11 11 11 11 11 11
